@@@@@@@@@@@@@@@@@@@@@@@@@@@@@@@@@@@@@@@@@@@@@@@@@@@@@@@@@@@@@@@@@@@@@@@@@@@@@@@@@@@@@@@@@@@@@@@@@@@@@@@@@@@@@@@@@@@@@@@@@@@@@@@@@@@@@@@@@@@@@@@@@@@@@@@@@@@@@@@@@@@@@@@@@@@@@@@@@@@@@@
@@@@@@@@@@@@@@@@@@@@@@@@@@@@@@@@@@@@@@@@@@@@@@@@@@@@@@@@@@@@@@@@@@@@@@@@@@@@@@@@@@@@@@@@@@@@@@@@@@@@@@@@@@@@@@@@@@@@@@@@@@@@@@@@@@@@@@@@@@@@@@@@@@@@@@@@@@@@@@@@@@@@@@@@@@@@@@@@@@@@@@
@\\\\|@@@\|@@@@@\\\\\\\\\\\\\|@@@\\\\\\\\\\\\|@@@\\\|/@@@@@@@@@@@@@@@@@@@@@@@@@@@@@@@@@@@@@@|///////@@@@@@@@@@@@@@@@@@@@@@@@@@|/////@@@@@@@@@@@@@@@@@@@@@@@@@@@@@@@@@@@@@@@@@@@@@@@@@@
@\\\\\\\\\|@@@@@\\\\\\\\\\\\\\\\\\\\\\\\\\\\\|\\\\\\|/@@@@@@\\\\\\\|@@@@@@@@@@@@@@@@@@@@@@@@|///////@@@@@@@@@@@@@@@@@@@@@@@@@@|/////@@@@@@@@@@|//////@@@@@@@@@|//////@@@@@|//@@@@@@@@@
@--------------------------------\\\\\\\\\\\\|\\\\\\|/@@@@@\\\\\\\\|@@@@@@@@@@@@@@@@@@@@@@@@|/////////@@@@@@@@@@@@@@@@@@\\\\\\|////////@@@@|////////////@@@@|////////////////@@@@@@@@@
@/////|@@@@////|@@@@////////|@@@@-\\\\\\\\\\\|/\\\\\|/@@@@@\\\\\\\\|@@@@@@@@@@@@@@@@@@@@@@@@|/////////@@@@@@@@@@@@@@@@@@\\\\\\|/////////@@@|/////////////@@@|////////////////@@@@@@@@@
@@@///|@@@-////|@@@@@///////|@@@@@\\\\\\\\\\\|---\\\|/@@@@@\\\\\\\\|@@@@@@@|@@@\\|//@@@@@@@@|///////////@@@@@@@@@@@@@@@@\\\\\\|//////////////////////////////////////////////@@@@@@@@@
@@@-\|----/////|-@@@@///////|@@@@@\\\\\\\\\\\|@@@\\\|-@@@@@\\\\\\\\\||@@@\\\\\\\\|//---@@@\|////////////@@@@@@@@@@@@@@@@\\\\\\|//////////////////////////////////////////////@@@@@@@@@
@@@--\|////////|\@@@-///////|@@@@@\\\\\\\\\\\|@@@\\\|@@@@@@\\\\\\\\\\|@@@\\\\\\\\|--@@|@@@\|////////////@@@@@@@@@@@@@@@@\\\\\\|//////////////////////////////////////////////@@@@@@@@@
@@@---\|///////|\@@@|///////|@@@@@\\\\\\\\\\\|@@@\\\|@@@@@@\\\\\\\\\\|@@@\\\\\\\\|@@@@|@@@\|////////////@@@@@@@@@@@@@@@@\\\\\\|//////////////////////////////////////////////@@@@@@@@@
@@@----\\\\\\\\||@@@\\\\\\\\|@@@@@-\\\\\\\\\\\\\\\\\|@@@@@@-------\\\|@@@\\\\\\\\|@@@@@@@@\|////////////@@@@@@@@@@@@@@@@\\\\\\|//////////////////////////////////////////////@@@@@@@@@
@@@|------\\\\\\|@@@--\\\\\\|@@@@@@\\\\\\\\\\\\\\\\\|/@@@@@-----\\\\\\\\\\\\\\\\\\|@@\\\\\\|///////|////@@@@@@@@@@@@@@@@\\\\\\|/////////----------///////////////////////////@@@@@@@@@
@\\\|----\\\\\\\|@@@@@\\\\\\|@@@@@@\\\\\\\\\\\\\\\\\|/@@@@@\\\\\\\\\\\\\\\\\\\\\\\\|\\\\\\\|///////|////@@@@@@@@@@@@@@@@\\\\\\|////////-@@@|\\\\/////////////////////////////@@@@@@@@@
@\\\\\------\\\\|@@@@@\\\\\\\|@@@\\\\\\\\\\\\\\\\\\\|/@@@@@\\\\\\\\\\\\\\\\\\\\\\\\\\\\\\\\|////////////@@@@@@@@@@@@@@@@-----\|//////--@@@@|\\///////////////////////////////@@@@@@@@@
@\\\\\|@@@@@\\\\|@@@@@\\\\\\\|@@@\\\\\\\\\\\\\\\\\\\|-@@@@@-----\\\\\\\\\\\\\\\\\\\\\\\\\\\|//////////--@@@@@@@@@@@@@@@@@@@@@-|/////-@@@@@@|////////////////////////////////-@@@@@@@@@
@--\\\|@@@@@\\\\|@@@@@\\\\\\\|@@@\\\\\\\\\\\\\\\\\\\|@@@@@@---\\\\\\\\\\\\\\\\\\\\\\\\\\\\\|//////////@@@@@@@@@@@@@@@@@@@@@@@@|/////@@@@@@@|////////////////////////////////@@@@@@@@@@
@@@---------\\\\|@@@@@\\\\\\\|@@@\\\\\\\\\\\\\\\\\\\|@@@@@@\\\\\\\\\\\\\\\\\\\\\\\\\\\\\\\\|//////////@@@@@@@@@@@@@@@@@@@@@@@@|/////@@@@@@@|////////////////////////////////@@@@@@@@@@
@@@|@@@@@@@@\\\\|@@@@@\\\\\\\|@@@-\\\\\\\\\\\\\\\\\\|@@@@@@\\\\\\\\\\\\\\\\\\--\\\\\\\\\\\\|///////////@@@@@@@@@@@@@@@@@@@@@@@|/////@@@@@@@|////////////////////////////////@@@@@@@@@@
@@@|@@@@@@@@\\\\|@@@@@\\\\\\\|@@@@\\\\\\\\\\\\\\\\\\\|@@@@@---\\\\\\\\\\\\\\\\\\\\\\\\\\\\\|/////////////@@@@@@@@@@@@@@@|////////////////////////////////////////////////////@@@@@@@@@
@--|@@@@@@@@\\\\|@@@\\\\\\\\\|@@@\\\\\\\\\\\\\\\\\\\\|@@@@@--\\\\\\\\\\\\\\\\\\\\\\\\\\\|\\|//|///////////@@@@@@@@@@@@|///-----------------------------------------------------@@@@@@@
@//|@@@@@\\\\\\\\\\\\\\\\\\\\\\\\\\\\\\\\\\\\\\\\\\\\|@@@@@\\\\\\\\\\\\\\\\\\\\\\\\\\\\\|\\|//|/////////////@@@@@@@@|////////////////////////////////////////////////////////////@@@@@
@//|@@@@@\\\\\\\\\\\\\\\\\\\\\\\\\\\\\\\\\\\\\\\\\\\\|@@@\\\\\\\\\\\\\\\\\\\\\\\\\\\\\\\\\\|////////////////////@@@|//////////////////////////////////////////////////////////////@@@@
@//|@@@@@------------------\\\\\\\\\\\\\\\\\\\\\\\\\\|@@@----\\\\\\\\\\\\\\\\\\\\\\\\--\\|\|/|//--////////////////////////--------------------------------//------------------------@@
@/|@@@@@@\\\\\\\\\\\\\\\\\\\-------------------------------\\\\\\\\\\\\\\\\\\\\\\\\\\\\\-\\|//-/////////////////////////////-------------------------------/////////////////////////@@
@\|@@@@@@\\\\\\\\\\\\\\\\\\\\\\\\\\\\\\\\\\\\\\\\\\\\\\\\\\\\\\\\\\\\\\\\\\\\\\\\\\\\\\\\\\|////////////////////////////////////////////////////////////////////////////////////////@@
@\|@@@@@@----------------------------------------------------------------------------------@----------------------------------------------------------------------------------------@@
@\\|@@@@@////////////////////////////////////////////|@@@//////////////////////////////////|\\\\\\\\\\\\\\\\\\\\\\\\\\\\\\\\\\\\\\\\\\\\\\\\\\\\\\\\\\\\\\\\\\\\\\\\\\\\\\\\\\\\\\\\@@
@\\|@@@@@////////////////////////////////////////////|@@@--/////////////////////////////-//|\\-\\\\\\\\\\\\\\\\\\\\\\\\\\\\\-------------------------------\\\\\\\\\\\\\\\\\\\\\\\\\@@
@\\|@@@@@|@@/////////////////////////////////////////|@@@@@--////////////////////////--//|/|\|\\--\\\\\\\\\\\@@@|\\\\\\\\\--------------------------------\\------------------------@@
@--|@@@@@@@@@///|@@@/////////|@@@@///////////////////|@@@@@////////////////////////////////|\\\\\\\\\\\\\\\\@@@@@@@@|\\\\\\\\\\\\\\\\\\\\\\\\\\\\\\\\\\\\\\\\\\\\\\\\\\\\\\\\\\\\\@@@@
@@@|@@@@@@@@-///|@@@/////////|@@@@///////////////////|@@@@@/////////////////////////////|//|\\|\\\\\\\\\\\@@@@@@@@@@@@|\\\\\\\\\\\\\\\\\\\\\\\\\\\\\\\\\\\\\\\\\\\\\\\\\\\\\\\\\@@@@@@
@@@\\|@@@@@@////|@@@/////////|@@@@@@////////////////|@@@@@@--///////////////////////////|//|\\|\\\\\\\\\@@@@@@@@@@@@@@@@|\----------------------------------------------------@@@@@@@@
@@@---------////|@@@/////////|@@@@@@////////////////|@@@@@@---/////////////////////////////|\\\\\\\\\\@@@@@@@@@@@@@@@@@@@@@@@|\\\\\\\@@@@@|\\\\\\\\\\\\\\\\\\\\\\\\\\\\\\\\\@@@@@@@@@@
@@@/////////////|@@@/////////|@@@@@-////////////////|@@@@@@//////////////////--////////////|\\\\\\\\\\@@@@@@@@@@@@@@@@@@@@@@@@|\\\\\@@@@@@@|\\\\\\\\\\\\\\\\\\\\\\\\\\\\\\\\@@@@@@@@@@
@@@/////////////|@@@/////////|@@@@@@@///////////////|-@@@@@////////////////////////////////|\\\\\\\\\\-@@@@@@@@@@@@@@@@@@@@@@@|\\\\\@@@@@@@|\\\\\\\\\\\\\\\\\\\\\\\\\\\\\\\\@@@@@@@@@@
@@@///|@@@@@////|@@@/////////|@@@@@@@///////////////|\@@@@@---/////////////////////////////|\\\\\\\\\\\-@@@@@@@@@@@@@@@@@@@@@@|\\\\\@@@@@@@|\\\\\\\\\\\\\\\\\\\\\\\\\\\\\\\\@@@@@@@@@@
@@@///|@@@@@////|@@@/////////|@@@@@--///////////////|\@@@@@-----///////////////////////////|\\\\\\\\\\\\@@@@@@@@@@@@@@@@------|\\\\\---@@@@|\\\\\\\\\\\\\\\\\\\\\\\\\\\\\\\\-@@@@@@@@@
@@@///|-----////|@@@@@@|@@@@@@@@@@@@@@@@@@@@@@@|@@@@@@@@@@@////////////////////////////////|\\\\\\\\\\\\@@@@@@@@@@@@@@@@//////|\\\\\\\\-@@@|///\\\\\\\\\\\\\\\\\\\\\\\\\\\\\\@@@@@@@@@
@@@///|/////////|@@@@@@|@@@@@@@@@@@@@@@@@@@@@@@@@@@@@@@@@@@////////////////////////|/|@@@@/|\\\\\\\|\\\\@@@@@@@@@@@@@@@@//////|\\\\\\\\\---------\\\\\\\\\\\\\\\\\\\\\\\\\\\\@@@@@@@@@
@@@@@@@@@@@@@@@@@@@@@@@@@@@@@@@@@@@@@@@@@@@@@@@@@@@@@@@@@@@-----/////|@@@//////////|/|@@@@/|\\\\\\\|\\\\@@@@@@@@@@@@@@@@//////|\\\\\\\\\\\\\\\\\\\\\\\\\\\\\\\\\\\\\\\\\\\\\\@@@@@@@@@
@@@@@@@@@@@@@@@@@@@@@@@@@@@@@@@@@@@@@@@@@@@@@@@@@@@@@@@@@@@-------///|@@@//////////|/|@@@@/|\\\\\\\\\\\\@@@@@@@@@@@@@@@@//////|\\\\\\\\\\\\\\\\\\\\\\\\\\\\\\\\\\\\\\\\\\\\\\@@@@@@@@@
@@@@@@@@@@@@@@@@@@@@@@@@@@@@@@@@@@@@@@@@@@@@@@@@@@@@@@@@@@@//////////|@@@////////////|@@@@/|\\\\\\\\\\\\@@@@@@@@@@@@@@@@//////|\\\\\\\\\\\\\\\\\\\\\\\\\\\\\\\\\\\\\\\\\\\\\\@@@@@@@@@
@@@@@@@@@@@@@@@@@@@@@@@@@@@@@@@@@@@@@@@@@@@@@@@@@@@@@@@@@@@////////|/|@@@//|@@@/|@@@/|@@@@/|\\\\\\\\\\\\@@@@@@@@@@@@@@@@//////|\\\\\\\\\\\\\\\\\\\\\\\\\\\\\\\\\\\\\\\\\\\\\\@@@@@@@@@
@@@@@@@@@@@@@@@@@@@@@@@@@@@@@@@@@@@@@@@@@@@@@@@@@@@@@@@@@@@////////|/|@@@//|@@@@@@@@/|@@@@/|\\\\\\\\\\@@@@@@@@@@@@@@@@@@//////|\\\\\\\\\\\\\\\\\\\\\\\\\\\\\\\\\\\\\\\\\\\\\\@@@@@@@@@
@@@@@@@@@@@@@@@@@@@@@@@@@@@@@@@@@@@@@@@@@@@@@@@@@@@@@@@@@@@////////|||@@@//|@@@@@@@@/|@@@@/|\\\\\\\\\\@@@@@@@@@@@@@@@@@@//////|\\\\\\\\\\\\\\\\\\\\\\\\\@@@|\\\\\\\\\\\\\\\\\@@@@@@@@@
@@@@@@@@@@@@@@@@@@@@@@@@@@@@@@@@@@@@@@@@@@@@@@@@@@@@@@@@@@@////////||@@@@@@|@@@@@@@@|@@@@@@|\\\\\\\\\\@@@@@@@@@@@@@@@@@@//////|\\\\\\\\@@@@|\\\\\\\\\\\\@@@@|\\\\\\\\\\\\\\\\@@@@@@@@@
@@@@@@@@@@@@@@@@@@@@@@@@@@@@@@@@@@@@@@@@@@@@@@@@@@@@@@@@@@@@///////|@@@@@@@@@@@@@@@@@@@@@@@@|\\\\\\\@@@@@@@@@@@@@@@@@@@@@@@@@/|\\\\\\@@@@@@@@|\\\\\\\@@@@@@@@@|\\\\\\\@@@@|\\@@@@@@@@@
@@@@@@@@@@@@@@@@@@@@@@@@@@@@@@@@@@@@@@@@@@@@@@@@@@@@@@@@@@@@@@@@@@@@@@@@@@@@@@@@@@@@@@@@@@@@@@@@@@@@@@@@@@@@@@@@@@@@@@@@@@@@@@|\\\\\@@@@@@@@@@|\\\\\\@@@@@@@@@|\\\\\\@@@@@|\\@@@@@@@@@
@@@@@@@@@@@@@@@@@@@@@@@@@@@@@@@@@@@@@@@@@@@@@@@@@@@@@@@@@@@@@@@@@@@@@@@@@@@@@@@@@@@@@@@@@@@@@@@@@@@@@@@@@@@@@@@@@@@@@@@@@@@@@@@@@@@@@@@@@@@@@@@@@@@@@@@@@@@@@@@@@@@@@@@@@@@@@@@@@@@@@@
@@@@@@@@@@@@@@@@@@@@@@@@@@@@@@@@@@@@@@@@@@@@@@@@@@@@@@@@@@@@@@@@@@@@@@@@@@@@@@@@@@@@@@@@@@@@@@@@@@@@@@@@@@@@@@@@@@@@@@@@@@@@@@@@@@@@@@@@@@@@@@@@@@@@@@@@@@@@@@@@@@@@@@@@@@@@@@@@@@@@@@
